0022222000
0211111220
2111111110
6111111110
0511111112
0761111116
0007666680
0000000000
0
3
9
5