0000000000
0022222200
0011111100
0012221100
2212222122
6666111166
0000766800
0000000000
0
5
9
5