0422222200
0566661100
0500007100
0520000100
0712222122
0076611666
0000072000
0000000000
1
0
9
5