0022222222
0051111111
0071111300
0021111300
0021111300
2211116800
6666680000
0000000000
0
6
9
1