0000000240
0022222110
0211111110
0111001110
2112000180
6111222300
0766666800
0000000000
8
0
0
5