2222222222
2111211112
6111211112
0711211112
0051111212
0076666212
0000000212
0000000212
0
2
8
7