0000000000
0022222222
0071666666
0001000000
0001002000
2221221200
6666666800
0000000000
0
6
9
2