0222220400
0111110100
2122112120
5122111110
5122111110
7111111110
0761666680
0001000000
7
0
3
7