0222420200
0711122120
0021111130
0211121130
0512222130
0712111120
0051112300
0052222200
4
0
2
7